1 1 1 1 1 1 1 1
1 15 1 1 1 1 1 1
1 1 1 1 1 1 1 1
1 1 1 1 1 1 1 1
1 1 1 1 1 1 1 1
1 1 1 1 1 1 1 1
1 1 1 1 1 1 0 15
1 1 1 1 1 15 2 1